p|consonant|bilabial|stop|voiceless
b|consonant|bilabial|stop|voiced
m|consonant|bilabial|nasal|voiced
f|consonant|labiodental|fricative|voiceless
v|consonant|labiodental|fricative|voiced
θ|consonant|interdental|fricative|voiceless
ð|consonant|interdental|fricative|voiced
t|consonant|alveolar|stop|voiceless
d|consonant|alveolar|stop|voiced
n|consonant|alveolar|nasal|voiced
s|consonant|alveolar|fricative|voiceless
z|consonant|alveolar|fricative|voiced
ɹ|consonant|alveolar|approximant|voiced
l|consonant|alveolar|approximant|voiced
ʃ|consonant|post-alveolar|fricative|voiceless
ʒ|consonant|post-alveolar|fricative|voiced
tʃ|consonant|post-alveolar|affricate|voiceless
dʒ|consonant|post-alveolar|affricate|voiced
j|consonant|palatal|approximant|voiced
k|consonant|velar|stop|voiceless
g|consonant|velar|stop|voiced
ŋ|consonant|velar|nasal|voiced
w|consonant|velar|approximant|voiced
h|consonant|glottal|fricative|voiceless
ʔ|consonant|glottal|stop|voiceless
i|vowel|front|high|voiced
ɪ|vowel|front|high|voiced
u|vowel|back|high|voiced
ʊ|vowel|back|high|voiced
e|vowel|front|mid|voiced
ɛ|vowel|front|mid|voiced
ʌ|vowel|central|mid|voiced
ə|vowel|central|mid|voiced
o|vowel|back|mid|voiced
æ|vowel|front|low|voiced
ɑ|vowel|back|low|voiced